"filename", "language", "Python", "comment", "blank", "total"
"c:\Users\relee\Code\Benedetta\trabajo-grado-v2\backend-v2\app\application\services\auth_service.py", "Python", 24, 0, 9, 33
"c:\Users\relee\Code\Benedetta\trabajo-grado-v2\backend-v2\app\application\services\notification_service.py", "Python", 16, 0, 5, 21
"c:\Users\relee\Code\Benedetta\trabajo-grado-v2\backend-v2\app\core\auth_utils.py", "Python", 9, 0, 4, 13
"c:\Users\relee\Code\Benedetta\trabajo-grado-v2\backend-v2\app\core\config.py", "Python", 14, 0, 5, 19
"c:\Users\relee\Code\Benedetta\trabajo-grado-v2\backend-v2\app\core\db.py", "Python", 33, 0, 3, 36
"c:\Users\relee\Code\Benedetta\trabajo-grado-v2\backend-v2\app\core\exceptions.py", "Python", 36, 0, 7, 43
"c:\Users\relee\Code\Benedetta\trabajo-grado-v2\backend-v2\app\core\security.py", "Python", 55, 0, 16, 71
"c:\Users\relee\Code\Benedetta\trabajo-grado-v2\backend-v2\app\domain\entities\cita_entity.py", "Python", 25, 0, 5, 30
"c:\Users\relee\Code\Benedetta\trabajo-grado-v2\backend-v2\app\domain\entities\especialidad_entity.py", "Python", 20, 0, 3, 23
"c:\Users\relee\Code\Benedetta\trabajo-grado-v2\backend-v2\app\domain\entities\especialista_entity.py", "Python", 37, 0, 8, 45
"c:\Users\relee\Code\Benedetta\trabajo-grado-v2\backend-v2\app\domain\entities\estadoCita_entity.py", "Python", 6, 0, 2, 8
"c:\Users\relee\Code\Benedetta\trabajo-grado-v2\backend-v2\app\domain\entities\officeConfig_entity.py", "Python", 7, 0, 3, 10
"c:\Users\relee\Code\Benedetta\trabajo-grado-v2\backend-v2\app\domain\entities\office_entity.py", "Python", 7, 0, 2, 9
"c:\Users\relee\Code\Benedetta\trabajo-grado-v2\backend-v2\app\domain\entities\paciente_entity.py", "Python", 33, 0, 10, 43
"c:\Users\relee\Code\Benedetta\trabajo-grado-v2\backend-v2\app\domain\entities\permission_entity.py", "Python", 10, 0, 3, 13
"c:\Users\relee\Code\Benedetta\trabajo-grado-v2\backend-v2\app\domain\entities\role_entity.py", "Python", 18, 0, 5, 23
"c:\Users\relee\Code\Benedetta\trabajo-grado-v2\backend-v2\app\domain\entities\tratamiento_entity.py", "Python", 17, 0, 3, 20
"c:\Users\relee\Code\Benedetta\trabajo-grado-v2\backend-v2\app\domain\entities\user_entity.py", "Python", 35, 5, 5, 45
"c:\Users\relee\Code\Benedetta\trabajo-grado-v2\backend-v2\app\infrastructure\notifiers\email_notifier.py", "Python", 18, 0, 7, 25
"c:\Users\relee\Code\Benedetta\trabajo-grado-v2\backend-v2\app\infrastructure\notifiers\push_notifier.py", "Python", 2, 0, 0, 2
"c:\Users\relee\Code\Benedetta\trabajo-grado-v2\backend-v2\app\infrastructure\repositories\cita_repo.py", "Python", 192, 3, 65, 260
"c:\Users\relee\Code\Benedetta\trabajo-grado-v2\backend-v2\app\infrastructure\repositories\especialidad_repo.py", "Python", 59, 0, 14, 73
"c:\Users\relee\Code\Benedetta\trabajo-grado-v2\backend-v2\app\infrastructure\repositories\especialista_repo.py", "Python", 116, 0, 31, 147
"c:\Users\relee\Code\Benedetta\trabajo-grado-v2\backend-v2\app\infrastructure\repositories\estadoCita_repo.py", "Python", 19, 0, 5, 24
"c:\Users\relee\Code\Benedetta\trabajo-grado-v2\backend-v2\app\infrastructure\repositories\officeConfig_repo.py", "Python", 24, 0, 8, 32
"c:\Users\relee\Code\Benedetta\trabajo-grado-v2\backend-v2\app\infrastructure\repositories\office_repo.py", "Python", 3, 0, 2, 5
"c:\Users\relee\Code\Benedetta\trabajo-grado-v2\backend-v2\app\infrastructure\repositories\paciente_repo.py", "Python", 79, 11, 31, 121
"c:\Users\relee\Code\Benedetta\trabajo-grado-v2\backend-v2\app\infrastructure\repositories\permission_repo.py", "Python", 20, 0, 6, 26
"c:\Users\relee\Code\Benedetta\trabajo-grado-v2\backend-v2\app\infrastructure\repositories\role_repo.py", "Python", 50, 5, 15, 70
"c:\Users\relee\Code\Benedetta\trabajo-grado-v2\backend-v2\app\infrastructure\repositories\tratamiento_repo.py", "Python", 45, 0, 15, 60
"c:\Users\relee\Code\Benedetta\trabajo-grado-v2\backend-v2\app\infrastructure\repositories\user_repo.py", "Python", 109, 8, 32, 149
"c:\Users\relee\Code\Benedetta\trabajo-grado-v2\backend-v2\app\infrastructure\schemas\cita.py", "Python", 45, 0, 7, 52
"c:\Users\relee\Code\Benedetta\trabajo-grado-v2\backend-v2\app\infrastructure\schemas\especialidad.py", "Python", 14, 0, 5, 19
"c:\Users\relee\Code\Benedetta\trabajo-grado-v2\backend-v2\app\infrastructure\schemas\especialista.py", "Python", 21, 0, 4, 25
"c:\Users\relee\Code\Benedetta\trabajo-grado-v2\backend-v2\app\infrastructure\schemas\estadoCita.py", "Python", 16, 0, 3, 19
"c:\Users\relee\Code\Benedetta\trabajo-grado-v2\backend-v2\app\infrastructure\schemas\office.py", "Python", 10, 0, 5, 15
"c:\Users\relee\Code\Benedetta\trabajo-grado-v2\backend-v2\app\infrastructure\schemas\officeConfig.py", "Python", 10, 0, 4, 14
"c:\Users\relee\Code\Benedetta\trabajo-grado-v2\backend-v2\app\infrastructure\schemas\paciente.py", "Python", 14, 0, 5, 19
"c:\Users\relee\Code\Benedetta\trabajo-grado-v2\backend-v2\app\infrastructure\schemas\permission.py", "Python", 12, 0, 4, 16
"c:\Users\relee\Code\Benedetta\trabajo-grado-v2\backend-v2\app\infrastructure\schemas\role.py", "Python", 13, 0, 4, 17
"c:\Users\relee\Code\Benedetta\trabajo-grado-v2\backend-v2\app\infrastructure\schemas\tratamiento.py", "Python", 13, 0, 5, 18
"c:\Users\relee\Code\Benedetta\trabajo-grado-v2\backend-v2\app\infrastructure\schemas\user.py", "Python", 21, 0, 5, 26
"c:\Users\relee\Code\Benedetta\trabajo-grado-v2\backend-v2\app\main.py", "Python", 34, 0, 8, 42
"c:\Users\relee\Code\Benedetta\trabajo-grado-v2\backend-v2\app\presentation\api\v1\auth_routes.py", "Python", 9, 0, 4, 13
"c:\Users\relee\Code\Benedetta\trabajo-grado-v2\backend-v2\app\presentation\api\v1\cita_routes.py", "Python", 62, 1, 18, 81
"c:\Users\relee\Code\Benedetta\trabajo-grado-v2\backend-v2\app\presentation\api\v1\especialidad_routes.py", "Python", 27, 0, 7, 34
"c:\Users\relee\Code\Benedetta\trabajo-grado-v2\backend-v2\app\presentation\api\v1\especialista_routes.py", "Python", 81, 0, 17, 98
"c:\Users\relee\Code\Benedetta\trabajo-grado-v2\backend-v2\app\presentation\api\v1\officeConfig_routes.py", "Python", 16, 0, 6, 22
"c:\Users\relee\Code\Benedetta\trabajo-grado-v2\backend-v2\app\presentation\api\v1\paciente_routes.py", "Python", 79, 8, 15, 102
"c:\Users\relee\Code\Benedetta\trabajo-grado-v2\backend-v2\app\presentation\api\v1\permission_routes.py", "Python", 11, 0, 5, 16
"c:\Users\relee\Code\Benedetta\trabajo-grado-v2\backend-v2\app\presentation\api\v1\role_routes.py", "Python", 26, 0, 7, 33
"c:\Users\relee\Code\Benedetta\trabajo-grado-v2\backend-v2\app\presentation\api\v1\tratamiento_routes.py", "Python", 27, 0, 7, 34
"c:\Users\relee\Code\Benedetta\trabajo-grado-v2\backend-v2\app\presentation\api\v1\user_routes.py", "Python", 27, 0, 10, 37
"c:\Users\relee\Code\Benedetta\trabajo-grado-v2\backend-v2\app\scripts\init_admin_role.py", "Python", 31, 0, 10, 41
"c:\Users\relee\Code\Benedetta\trabajo-grado-v2\backend-v2\app\scripts\init_admin_user.py", "Python", 47, 0, 11, 58
"c:\Users\relee\Code\Benedetta\trabajo-grado-v2\backend-v2\app\scripts\init_estados_cita.py", "Python", 31, 0, 7, 38
"c:\Users\relee\Code\Benedetta\trabajo-grado-v2\backend-v2\app\scripts\init_office_config.py", "Python", 30, 0, 11, 41
"c:\Users\relee\Code\Benedetta\trabajo-grado-v2\backend-v2\app\scripts\init_permissions.py", "Python", 56, 3, 19, 78
"c:\Users\relee\Code\Benedetta\trabajo-grado-v2\backend-v2\app\shared\dto\mailData_dto.py", "Python", 11, 0, 3, 14
"c:\Users\relee\Code\Benedetta\trabajo-grado-v2\backend-v2\app\shared\dto\token_dto.py", "Python", 8, 0, 3, 11
"c:\Users\relee\Code\Benedetta\trabajo-grado-v2\backend-v2\app\shared\utils.py", "Python", 33, 0, 12, 45
"Total", "-", 1973, 44, 560, 2577